########
#A.....#
###..#.#
###....#
#......#
#######B